intrinsic - неотъемлемая часть, внутренний
dimension - измерение
rank - звание
intensify - усилить, усиливать
capricious - капризный
tangible - материальное
conflict - конфликт
precipitation - осадки
status quo - статус-кво
hillarious - веселый
incompetent - некомпетентный
esthetically - эстетично
exotic - экзотический
realism - реализм
cause - причина
manipulation - манипуляция
cease - прекращение
perspective - перспектива
gala - праздничный
fertilize - удобрение
an inscription - надпись
commodity - товар
spectrum - спектр
bulk - тяжелый вид, навалом, масса
hedonistic - гедонистический, учение о счастье
context - контекст
adversely - неблагоприятно
fringe - край, грань (бахрома)
subsidy - субсидия
obtain - получить
illiterate - неграмотный
skit - скетч, короткая игра, пародия
charismatic - харизматический
phonetic - фонетический
irrigation - полив, орошение
hierarchy - иерархия
artillery - артиллерия
ambiguous - двусмысленный, неопределенный
trend - тенденция
photosynthesis - фотосинтез
aggregate - совокупный, общий
allocate - распределять
equity - капитал
minimum - минимум
abstract - абстракция, аннотация
depict - изображать
delinquency - просрочка
medium - средний
adolescent - подростковый
symbolic - символический
amateurish - дилетанский
cultivation - выращивание
net - чистая
in the trenches - в окопах
vanity - тщеславие
portrayal - изображение кого-то, портрет
strategic - стратегическое
to denote - обозначать
to decipher - расшифровать
ingenious - гениальный
zeal - усердие, энтузиазм
per capita - на душу населения
striking - поразительный, заметный
hypocritically - лицемерно
inhibit - подавить, запретить
improvisation - импровизация
vulnerable - уязвимый
abandon - бросать, сдаваться
cumbersome - громоздкий
inflation - инфляция
a connotation - то, что подразумевается, созначение
rebel - бунтарь
cast - группа актеров
mobilize - мобилизировать
ratio - соотношение
decline - снижать, отменять
allegiance - лояльность
regulate - регулировать
battle - бой
